xxxxxxxxxxxxxxxxxxxx
xA                 x
x                  x
x                  x
x                  x
x                  x
x                  x
x                  x
x                  x
x                  x
xxxxxxxxxxx        x
x         x        x
x         x        x
x         x        x
x                  x
x     xxxxxxxxx    x
x                  x
x                  x
x                 Bx
xxxxxxxxxxxxxxxxxxxx